20 20
115 116 116 116 116 116 116 116 116 116 116 116 116 116 116 116 116 116 116 117
127 022 022 022 022 022 022 022 022 022 022 022 022 022 022 022 022 022 022 129
127 022 022 022 022 022 022 022 022 022 022 022 022 022 022 022 022 022 022 129
127 022 022 022 116 116 116 116 116 116 116 116 116 116 116 116 022 022 022 129
127 022 007 034 008 022 022 022 022 022 022 022 022 022 022 022 022 022 022 129
127 022 023 051 021 022 022 022 022 022 022 022 022 022 022 022 022 022 022 129
127 022 023 051 033 034 034 034 034 034 008 022 022 022 022 022 022 022 022 129
127 022 023 051 051 051 051 051 051 051 021 022 022 022 022 022 022 022 022 129
127 022 019 010 010 010 010 010 010 010 020 022 022 022 022 022 022 022 022 129
127 022 022 022 022 022 022 022 022 022 022 022 022 022 022 022 022 022 022 129
127 022 022 022 022 022 022 022 022 022 022 022 022 022 022 022 022 022 022 129
127 022 022 022 022 022 022 022 022 022 022 022 022 022 022 022 022 022 022 129
127 022 022 022 022 022 022 022 022 022 022 022 022 022 022 022 022 022 022 129
127 022 022 022 022 022 022 022 022 022 022 022 022 022 022 022 022 022 022 129
127 022 022 022 022 022 022 022 022 022 022 022 022 022 022 022 022 022 022 129
127 022 022 022 022 022 022 022 022 022 022 022 022 022 022 022 022 022 022 129
127 022 022 022 022 022 022 022 022 022 022 022 022 022 022 022 022 022 022 129
127 022 022 022 022 022 022 022 022 022 022 022 022 022 022 022 022 022 022 129
127 022 022 022 022 022 022 022 022 022 022 022 022 022 022 022 022 022 022 129
139 140 140 140 140 140 140 140 140 140 140 140 140 140 140 140 140 140 140 141