20 20
000 001 001 001 001 001 001 001 001 002 -01 -01 -01 -01 -01 -01 -01 -01 -01 -01
006 015 015 015 015 015 015 015 015 008 -01 -01 -01 -01 -01 -01 -01 -01 -01 -01
006 015 015 015 015 015 015 015 015 008 -01 -01 -01 -01 -01 -01 -01 -01 -01 -01
006 015 015 015 015 015 015 015 015 008 -01 -01 -01 -01 -01 -01 -01 -01 -01 -01
006 015 015 015 015 015 015 015 015 008 -01 -01 -01 -01 -01 -01 -01 -01 -01 -01
006 015 015 015 015 015 015 015 015 008 -01 -01 -01 -01 -01 -01 -01 -01 -01 -01
006 015 015 015 015 015 015 015 015 008 -01 -01 -01 -01 -01 -01 -01 -01 -01 -01
006 015 015 015 015 015 015 015 015 008 -01 -01 -01 -01 -01 -01 -01 -01 -01 -01
006 015 015 015 015 015 015 015 015 008 -01 -01 -01 -01 -01 -01 -01 -01 -01 -01
012 013 013 013 013 013 013 013 013 014 -01 -01 -01 -01 -01 -01 -01 -01 -01 -01
003 -01 -01 -01 -01 -01 -01 -01 -01 -01 -01 -01 -01 -01 -01 -01 -01 -01 -01 -01
003 -01 -01 -01 -01 -01 -01 -01 -01 -01 -01 -01 -01 -01 -01 -01 -01 -01 -01 -01
003 -01 -01 -01 -01 -01 -01 -01 -01 -01 -01 -01 -01 -01 -01 -01 -01 -01 -01 -01
003 -01 -01 -01 -01 -01 -01 -01 -01 -01 -01 -01 -01 -01 -01 -01 -01 -01 -01 -01
003 -01 -01 -01 -01 -01 -01 -01 -01 -01 -01 -01 -01 -01 -01 -01 -01 -01 -01 -01
003 -01 -01 -01 -01 -01 -01 -01 -01 -01 -01 -01 -01 -01 -01 -01 -01 -01 -01 -01
003 -01 -01 -01 -01 -01 -01 -01 -01 -01 -01 -01 -01 -01 -01 -01 -01 -01 -01 -01
003 -01 -01 -01 -01 -01 -01 -01 -01 -01 -01 -01 -01 -01 -01 -01 -01 -01 -01 -01
003 -01 -01 -01 -01 -01 -01 -01 -01 -01 -01 -01 -01 -01 -01 -01 -01 -01 -01 -01
006 -01 -01 -01 -01 -01 -01 -01 -01 -01 -01 -01 -01 -01 -01 -01 -01 -01 -01 -01